111111111111111111111111
100010010000010000010001
100011010000010000100001
100000000111000001000011
100000000000001000001001
100001000000000000100001
111111111111111111111111