111111111111111111111111
100000000000000000000001
100000000000000000000001111111111111111
100000000011000000000000000000000000001
10000000001100000000000001111111111111
10000000000000000000000100000000000001
11111111111111111111111111111111111111