11111111111111111111111
10111100000000000000001
10111100000000000000001
10111100000000000000001
10111100000000000000001
11111111111111111111111