

NO  textures/TECH_3B.xpm
SO textures/TECH_3B.xpm 
EA textures/TECH_1C.xpm 
WE textures/TECH_3B.xpm
F 26,26,24
C 46,58,63


                          1111111111111111111111111
                          1000000000110000000000001
                          1011000001110000000000001
                          1001000000000000000000001
1111111110110000011100000000000011
1000000000110000011101111111111111
1111011111111101110000001000111111  
1111011111111101110101001000111111
1100000011010101110000000000111111
1000000000000000110000001000111111      
100000000000 000011010100S1000111111                                                                    
1000001110101011111011110 01
11110111 1110101 10111101000111111
11111111 1111111 11111111111111111
