NO  textures/TECH_3B.xpm
SO textures/TECH_3B.xpm
EA textures/TECH_3B.xpm 
WE textures/TECH_3B.xpm
F 26,26,24
C 46,58,63

111111
11N001111
110000011
111111111