NO textures/TECH_3B.xpm
SO textures/TECH_3B.xpm
EA textures/TECH_3B.xpm
WE textures/TECH_3B.xpm
F 26,26,24
C 46,58,63


1111111111111
100000000000001111
101   
10000N000001111
11111111111