NO /gggg
SO /ffff
EA /gggg
WE /dddd
F 002,111,222
C 111,222,222


111111111
1000000N1
111110001
100010011
100000001
111111111