NO textures/TECH_3B.xpm
SO textures/TECH_3B.xpm
EA textures/TECH_3B.xpm
WE textures/TECH_3B.xpm
F 26,26,24
C 46,58,63


111111111
100000001111111111111111
111000000000000000000001
100W00010000000000000011
100001011111111111111111
100010001
111111111