NO /gggg
SO /ffff
EA /gggg
WE /dddd
F 002,111,222
C 111,222,222


111111111
100000001
111100001
100010011
1001W1011
100010001
111111111