NO /gggg
SO /ffff
EA /gggg
WE /dddd
F 002,111,222
C 111,222,222


111111111
100000001111111111111111
111000000000000000000001
100W00010000000000000011
100001011111111111111111
100010001
111111111