NO textures/TECH_3B.xpm
SO textures/TECH_3B.xpm
EA textures/TECH_3B.xpm
WE textures/TECH_3B.xpm
F 26,26,24
C 46,58,63


111111111
100001001111111111111111
11101W00000000000000011
101000000000000000000011
100000010111111111111111
1000001
11111111