NO /gggg
SO /ffff
EA /gggg
WE /dddd
F 002,111,222
C 111,222,333


111111111111111111111111111111111111111111111111111111111111111111
100000000000000000000000000000000000000000000000000000000000000001
10000000000P000000000000111111111111111111111111111111111111111111
1000000000110000000000000000000000000011111111
1000000000110000000000000001111111111111111111
1000000000000000000000010000000000000001111111
1111111111111111111111111111111111111111111111